1111111111111
1C0000E001001
10C00000CY001
1000CY0001001
100C000001001
10010001C0001
1000001P0Y0C1
1111111111111
