1111111111111
1000001E11001
1000000001101
1001000011001
10000C0001001
1001000100001
100P101000001
1111111111111