1111111111111
1CCCC0CE01001
10C00000CY001
1Y00C00001001
100C00Y001001
10010P01C0001
10Y01010000C1
1111111111111